{
    "TICKETMASTER": "VIAGOGO",
    "-----------" : "------------",
    "ASSIS" : ["Catégorie 2", "Catégorie 1"],
    "DEBOUT" : ["Parterre"],
    "PA DEBOUT" : ["Parterre"],
    "FOSSE" : ["Standing"],
    "DEBOUT EARLY" : ["Standing Early"],
    "EARLY": ["Early"],
    "EARLY ENTRANCE": ["Early"],
    "A1" : ["A1"],
    "A2" : ["A2"],
    "A3" : ["A3"],
    "A4" : ["A4"],
    "A5" : ["A5"],
    "B1" : ["B1"],
    "B2" : ["B2"],
    "B3" : ["B3"],
    "B4" : ["B4"],
    "C1" : ["C1"],
    "C2" : ["C2"],
    "C3" : ["C3"],
    "D1" : ["D1"],
    "D2" : ["D2"],
    "D3" : ["D3"],
    "D4" : ["D4"],
    "E1" : ["E1"],
    "E2" : ["E2"],
    "E3" : ["E3"],
    "E4" : ["E4"],
    "E5" : ["E5"],
    "F1" : ["F1"],
    "F2" : ["F2"],
    "F3" : ["F3"],
    "F4" : ["F4"],
    "F5" : ["F5"],
    "F6" : ["F6"],
    "F7" : ["F7"],
    "F8" : ["F8"],
    "F9" : ["F9"],
    "G1" : ["G1"],
    "G2" : ["G2"],
    "G3" : ["G3"],
    "G4" : ["G4"],
    "G5" : ["G5"],
    "H1" : ["H1"],
    "H2" : ["H2"],
    "H3" : ["H3"],
    "H4" : ["H4"],
    "H5" : ["H5"],
    "H6" : ["H6"],
    "H7" : ["H7"],
    "H8" : ["H8"],
    "H9" : ["H9"],
    "I1" : ["I1"],
    "I2" : ["I2"],
    "I3" : ["I3"],
    "I4" : ["I4"],
    "I5" : ["I5"],
    "J1" : ["J1"],
    "J2" : ["J2"],
    "J3" : ["J3"],
    "K1" : ["K1"],
    "K2" : ["K2"],
    "K3" : ["K3"],
    "L1" : ["L1"],
    "L2" : ["L2"],
    "L3" : ["L3"]
}